FECHA ,CIUDADELA ,ALTO_OBRAJES ,SEGUENCOMA ,BOLOGNIA ,RIO_SECO ,total
2016-11-01 ,2389 ,11149 ,5129 ,5850 ,4972 ,29489
2016-11-02 ,2330 ,6805 ,4980 ,4526 ,3371 ,22012
2016-11-03 ,3534 ,12879 ,5826 ,6411 ,5585 ,34235
2016-11-04 ,2791 ,12916 ,5964 ,6196 ,5007 ,32874
2016-11-05 ,2454 ,8753 ,4430 ,4599 ,3809 ,24045
2016-11-06 ,2154 ,7262 ,3773 ,4058 ,3594 ,20841
2016-11-07 ,2913 ,12165 ,5853 ,6023 ,4694 ,31648
2016-11-08 ,2853 ,12569 ,5460 ,5865 ,4690 ,31437
2016-11-09 ,2907 ,12207 ,5594 ,6295 ,4730 ,31733
2016-11-10 ,2913 ,12247 ,5678 ,5876 ,4768 ,31482
2016-11-11 ,2832 ,12179 ,5888 ,6187 ,4602 ,31688
2016-11-12 ,2490 ,8169 ,4822 ,4731 ,4606 ,24818
2016-11-13 ,2316 ,7120 ,4002 ,3814 ,3450 ,20702
2016-11-14 ,3141 ,11931 ,5803 ,5943 ,4846 ,31664
2016-11-15 ,2690 ,11160 ,5725 ,5835 ,4845 ,30255
2016-11-16 ,2852 ,11982 ,5350 ,6117 ,5103 ,31404
2016-11-17 ,2693 ,11851 ,5682 ,5946 ,5226 ,31398
2016-11-18 ,2833 ,11794 ,5568 ,5811 ,4696 ,30702
2016-11-19 ,2083 ,8266 ,4687 ,4257 ,4754 ,24047
2016-11-20 ,2212 ,7019 ,4361 ,3817 ,3429 ,20838
2016-11-21 ,2885 ,11059 ,5601 ,5579 ,4689 ,29813
2016-11-22 ,2671 ,11589 ,5518 ,4009 ,4428 ,28215
2016-11-23 ,2965 ,11673 ,5747 ,5634 ,4413 ,30432
2016-11-24 ,2575 ,11268 ,5803 ,5564 ,4729 ,29939
2016-11-25 ,2657 ,11491 ,5880 ,5556 ,4627 ,30211
2016-11-26 ,1933 ,7433 ,4465 ,4047 ,3589 ,21467
2016-11-27 ,2028 ,5803 ,3488 ,3416 ,2549 ,17284
2016-11-28 ,2537 ,11477 ,5420 ,5497 ,4398 ,29329
2016-11-29 ,2757 ,11330 ,5407 ,5358 ,4619 ,29471
2016-11-30 ,2605 ,11430 ,4924 ,5259 ,4300 ,28518
2016-12-01 ,2227 ,11370 ,4843 ,4900 ,4280 ,27620
2016-12-02 ,2249 ,11404 ,4836 ,5355 ,4298 ,28142
2016-12-03 ,1868 ,8004 ,3946 ,4016 ,3672 ,21506
2016-12-04 ,1991 ,6574 ,3646 ,3330 ,3279 ,18820
2016-12-05 ,1977 ,10944 ,5052 ,5314 ,4251 ,27538
2016-12-06 ,2116 ,11116 ,4862 ,5214 ,4011 ,27319
2016-12-07 ,2320 ,11211 ,5372 ,5607 ,4218 ,28728
2016-12-08 ,2099 ,10881 ,4681 ,4995 ,3756 ,26412
2016-12-09 ,2104 ,11489 ,5001 ,4975 ,4269 ,27838
2016-12-10 ,3069 ,8981 ,5532 ,5172 ,4588 ,27342
2016-12-11 ,2253 ,7238 ,4160 ,3651 ,3719 ,21021
2016-12-12 ,2245 ,11116 ,4895 ,5191 ,4110 ,27557
2016-12-13 ,1972 ,10846 ,4826 ,4981 ,3956 ,26581
2016-12-14 ,2319 ,10755 ,4568 ,5117 ,4050 ,26809
2016-12-15 ,2135 ,11205 ,4686 ,4937 ,4062 ,27025
2016-12-16 ,2259 ,11300 ,4686 ,4787 ,3891 ,26923
2016-12-17 ,2151 ,8034 ,4386 ,3883 ,3744 ,22198
2016-12-18 ,2385 ,8016 ,4530 ,4051 ,3863 ,22845
2016-12-19 ,2074 ,10442 ,4713 ,4811 ,3921 ,25961
2016-12-20 ,2057 ,10287 ,4635 ,4997 ,3849 ,25825
2016-12-21 ,2192 ,10481 ,4818 ,5123 ,3944 ,26558
2016-12-22 ,1954 ,10593 ,4892 ,5097 ,4009 ,26545
2016-12-23 ,3432 ,10538 ,5112 ,5301 ,4603 ,28986
2016-12-24 ,2111 ,7200 ,4438 ,3808 ,4084 ,21641
2016-12-25 ,2635 ,7733 ,4473 ,3759 ,3591 ,22191
2016-12-26 ,2314 ,6680 ,3777 ,3464 ,2894 ,19129
2016-12-27 ,1885 ,9175 ,3985 ,4283 ,3092 ,22420
2016-12-28 ,2283 ,9090 ,3826 ,4479 ,3246 ,22924
2016-12-29 ,1947 ,9160 ,3969 ,4312 ,3002 ,22390
2016-12-30 ,1758 ,9125 ,3932 ,4030 ,2882 ,21727
2016-12-31 ,1479 ,5096 ,3310 ,2485 ,2375 ,14745
2017-01-01 ,2294 ,6756 ,3658 ,3184 ,3115 ,19007
2017-01-02 ,2321 ,7357 ,3686 ,3706 ,3189 ,20259
2017-01-03 ,1943 ,9149 ,4115 ,4530 ,3107 ,22844
2017-01-04 ,1952 ,8999 ,4135 ,4328 ,3174 ,22588
2017-01-05 ,1843 ,9523 ,4011 ,4469 ,3246 ,23092
2017-01-06 ,1484 ,9504 ,4469 ,4497 ,3614 ,23568
2017-01-07 ,2764 ,5709 ,3205 ,4418 ,1862 ,17958
2017-01-08 ,1860 ,5734 ,2883 ,4084 ,2308 ,16869
2017-01-09 ,2063 ,9021 ,4300 ,5189 ,3176 ,23749
2017-01-10 ,1941 ,9716 ,4328 ,5023 ,3230 ,24238
2017-01-11 ,2244 ,9340 ,4569 ,5224 ,3447 ,24824
2017-01-12 ,1938 ,9647 ,4463 ,4939 ,3288 ,24275
2017-01-13 ,2139 ,10018 ,4254 ,4568 ,3284 ,24263
2017-01-14 ,1899 ,7024 ,3669 ,3443 ,2728 ,18763
2017-01-15 ,2057 ,6579 ,3938 ,3477 ,2938 ,18989
2017-01-16 ,2115 ,10112 ,4808 ,5298 ,3827 ,26160
2017-01-17 ,1918 ,10295 ,4647 ,5492 ,3460 ,25812
2017-01-18 ,2001 ,10189 ,4729 ,5154 ,3372 ,25445
2017-01-19 ,2020 ,10129 ,4443 ,5181 ,3474 ,25247
2017-01-20 ,2150 ,10541 ,4813 ,5170 ,3844 ,26518
2017-01-21 ,1862 ,7077 ,3925 ,3767 ,3055 ,19686
2017-01-22 ,2105 ,7199 ,3779 ,3878 ,3143 ,20104
2017-01-23 ,1607 ,5857 ,3408 ,3272 ,2520 ,16664
2017-01-24 ,2416 ,9061 ,5093 ,5145 ,4046 ,25761
2017-01-25 ,2122 ,10072 ,4522 ,5213 ,3788 ,25717
2017-01-26 ,1830 ,10689 ,4635 ,5622 ,4033 ,26809
2017-01-27 ,1890 ,11213 ,5030 ,5827 ,3921 ,27881
2017-01-28 ,1830 ,8212 ,4472 ,4672 ,3746 ,22932
2017-01-29 ,2238 ,8065 ,4604 ,4789 ,3887 ,23583
2017-01-30 ,2080 ,11007 ,4945 ,5437 ,3795 ,27264
2017-01-31 ,1977 ,10931 ,4783 ,5527 ,3719 ,26937
2017-02-01 ,2079 ,10775 ,4778 ,5678 ,3881 ,27191
2017-02-02 ,2193 ,10850 ,4818 ,5408 ,3933 ,27202
2017-02-03 ,2164 ,11801 ,4883 ,5478 ,4246 ,28572
2017-02-04 ,1809 ,8120 ,4391 ,4770 ,3757 ,22847
2017-02-05 ,2008 ,7003 ,3944 ,4134 ,3537 ,20626
2017-02-06 ,3206 ,11251 ,5452 ,5789 ,4836 ,30534
2017-02-07 ,2873 ,11380 ,5444 ,5786 ,4841 ,30324
2017-02-08 ,2826 ,11372 ,5382 ,5569 ,4876 ,30025
2017-02-09 ,2751 ,11504 ,5357 ,5556 ,5001 ,30169
2017-02-10 ,2805 ,12364 ,5817 ,5883 ,4920 ,31789
2017-02-11 ,1700 ,7933 ,4466 ,4396 ,3568 ,22063
2017-02-12 ,1803 ,6879 ,3849 ,3986 ,3337 ,19854
2017-02-13 ,2910 ,11850 ,5595 ,5498 ,4853 ,30706
2017-02-14 ,2917 ,11838 ,5728 ,5666 ,5059 ,31208
2017-02-15 ,2866 ,12067 ,6394 ,6194 ,4981 ,32502
2017-02-16 ,2649 ,11710 ,5591 ,5597 ,4837 ,30384
2017-02-17 ,3085 ,12231 ,5711 ,5726 ,4874 ,31627
2017-02-18 ,1929 ,8174 ,4524 ,4361 ,3722 ,22710
2017-02-19 ,1753 ,6417 ,4231 ,3934 ,3415 ,19750
2017-02-20 ,3043 ,11840 ,6082 ,5816 ,5178 ,31959
2017-02-21 ,2828 ,10616 ,5693 ,5529 ,4099 ,28765
2017-02-22 ,3016 ,12311 ,6180 ,6010 ,4827 ,32344
2017-02-23 ,2572 ,11668 ,5649 ,5480 ,5052 ,30421
2017-02-24 ,2210 ,10921 ,5272 ,5085 ,4520 ,28008
2017-02-25 ,2712 ,7232 ,5065 ,3615 ,3166 ,21790
2017-02-26 ,2186 ,4752 ,3625 ,2898 ,2659 ,16120
2017-02-27 ,2057 ,4530 ,3370 ,2693 ,3049 ,15699
2017-02-28 ,2110 ,5310 ,3175 ,2857 ,3142 ,16594
2017-03-01 ,3232 ,11801 ,5629 ,5797 ,5264 ,31723
2017-03-02 ,3033 ,11771 ,5784 ,5810 ,4686 ,31084
2017-03-03 ,3111 ,12282 ,5735 ,5962 ,5053 ,32143
2017-03-04 ,1902 ,7886 ,4753 ,4360 ,3855 ,22756
2017-03-05 ,1814 ,6022 ,4126 ,4221 ,2633 ,18816
2017-03-06 ,3075 ,11577 ,5607 ,5654 ,4715 ,30628
2017-03-07 ,2939 ,11361 ,5630 ,5495 ,4858 ,30283
2017-03-08 ,2981 ,11277 ,5751 ,5578 ,4658 ,30245
2017-03-09 ,2695 ,11789 ,5765 ,5597 ,4908 ,30754
2017-03-10 ,2878 ,11906 ,5498 ,5518 ,4577 ,30377
2017-03-11 ,1850 ,7601 ,4343 ,3712 ,3218 ,20724
2017-03-12 ,1960 ,6559 ,3675 ,3226 ,2716 ,18136
2017-03-13 ,3079 ,11552 ,5604 ,5541 ,4716 ,30492
2017-03-14 ,3007 ,11437 ,5523 ,5623 ,4902 ,30492
2017-03-15 ,2883 ,11885 ,5646 ,5886 ,4688 ,30988
2017-03-16 ,2708 ,12203 ,5665 ,5929 ,4656 ,31161
2017-03-17 ,2987 ,12161 ,5785 ,5789 ,4640 ,31362
2017-03-18 ,1891 ,8516 ,4777 ,3903 ,3479 ,22566
2017-03-19 ,2050 ,6720 ,4527 ,3750 ,3353 ,20400
2017-03-20 ,2805 ,11832 ,5621 ,5814 ,4873 ,30945
2017-03-21 ,3262 ,11917 ,6188 ,6158 ,5229 ,32754
2017-03-22 ,3010 ,12117 ,6495 ,6276 ,5286 ,33184
2017-03-23 ,2945 ,11484 ,6299 ,5807 ,5198 ,31733
2017-03-24 ,2635 ,11300 ,5502 ,5483 ,4616 ,29536
2017-03-25 ,1926 ,7863 ,4702 ,4009 ,3542 ,22042
2017-03-26 ,1585 ,5957 ,3553 ,3390 ,2729 ,17214
2017-03-27 ,2740 ,11397 ,5706 ,5698 ,4629 ,30170
2017-03-28 ,2760 ,11371 ,5677 ,5495 ,4890 ,30193
2017-03-29 ,2793 ,11184 ,5773 ,5580 ,4735 ,30065
2017-03-30 ,2765 ,11740 ,5511 ,5344 ,4763 ,30123
2017-03-31 ,2812 ,11644 ,5636 ,5348 ,4636 ,30076
2017-04-01 ,1689 ,6884 ,4258 ,3854 ,3237 ,19922
2017-04-02 ,1712 ,5491 ,3192 ,2990 ,2493 ,15878
2017-04-03 ,2794 ,12124 ,5462 ,5638 ,4803 ,30821
2017-04-04 ,2765 ,11862 ,5547 ,5445 ,4748 ,30367
2017-04-05 ,2884 ,11139 ,5439 ,5459 ,4895 ,29816
2017-04-06 ,2584 ,11975 ,5602 ,5453 ,4847 ,30461
2017-04-07 ,2699 ,12002 ,5631 ,5298 ,4688 ,30318
2017-04-08 ,1814 ,7293 ,4256 ,3624 ,3143 ,20130
2017-04-09 ,2083 ,5869 ,3478 ,3178 ,2800 ,17408
2017-04-10 ,2796 ,11511 ,5111 ,5591 ,4427 ,29436
2017-04-11 ,2806 ,11564 ,5796 ,5237 ,4812 ,30215
2017-04-12 ,2816 ,11335 ,5636 ,5277 ,4677 ,29741
2017-04-13 ,2341 ,10550 ,4837 ,4829 ,4285 ,26842
2017-04-14 ,2227 ,7413 ,3528 ,3157 ,2877 ,19202
2017-04-15 ,1764 ,7371 ,3718 ,3352 ,2762 ,18967
2017-04-16 ,1956 ,6542 ,3540 ,3193 ,2497 ,17728
2017-04-17 ,2518 ,11437 ,5416 ,5200 ,4516 ,29087
2017-04-18 ,2809 ,11206 ,5587 ,5263 ,4486 ,29351
2017-04-19 ,2596 ,11446 ,5582 ,5532 ,4361 ,29517
2017-04-20 ,2564 ,11668 ,5513 ,5576 ,4241 ,29562
2017-04-21 ,2866 ,11871 ,5717 ,5494 ,4553 ,30501
2017-04-22 ,1934 ,7771 ,4686 ,3921 ,3534 ,21846
2017-04-23 ,2033 ,6283 ,3790 ,3346 ,2896 ,18348
2017-04-24 ,2763 ,11525 ,5685 ,5330 ,4315 ,29618
2017-04-25 ,2583 ,11264 ,5802 ,5381 ,4391 ,29421
2017-04-26 ,2635 ,11663 ,5733 ,5494 ,4470 ,29995
2017-04-27 ,2524 ,11542 ,5626 ,5247 ,4491 ,29430
2017-04-28 ,2599 ,11459 ,5507 ,5260 ,4617 ,29442
2017-04-29 ,1917 ,6660 ,3957 ,3211 ,3016 ,18761
2017-04-30 ,2213 ,6697 ,3509 ,3177 ,3030 ,18626
2017-05-01 ,1848 ,6108 ,3775 ,3124 ,2513 ,17368
2017-05-02 ,3080 ,11542 ,5466 ,5215 ,4582 ,29885
2017-05-03 ,2959 ,11690 ,5663 ,5660 ,4517 ,30489
2017-05-04 ,2818 ,11564 ,5794 ,5295 ,4703 ,30174
2017-05-05 ,2759 ,11610 ,5660 ,5401 ,4512 ,29942
2017-05-06 ,2018 ,7406 ,4563 ,4083 ,3682 ,21752
2017-05-07 ,1998 ,6085 ,3865 ,3379 ,2669 ,17996
2017-05-08 ,2823 ,11670 ,5651 ,5447 ,4673 ,30264
2017-05-09 ,2643 ,11594 ,5456 ,5145 ,4339 ,29177
2017-05-10 ,2633 ,11259 ,5610 ,5259 ,4229 ,28990
2017-05-11 ,2633 ,11186 ,5521 ,5333 ,4578 ,29251
2017-05-12 ,2853 ,11820 ,5622 ,5403 ,4478 ,30176
2017-05-13 ,2175 ,8175 ,4806 ,4045 ,4151 ,23352
2017-05-14 ,1772 ,6398 ,4065 ,3519 ,3015 ,18769
2017-05-15 ,2743 ,11148 ,5667 ,5453 ,4238 ,29249
2017-05-16 ,2731 ,11147 ,5636 ,5586 ,4500 ,29600
2017-05-17 ,760 ,13884 ,4601 ,4445 ,1468 ,25158
2017-05-18 ,3024 ,12395 ,5548 ,5723 ,4514 ,31204
2017-05-19 ,2800 ,11560 ,5524 ,5496 ,4229 ,29609
2017-05-20 ,2202 ,8855 ,5203 ,4448 ,4019 ,24727
2017-05-21 ,1955 ,7308 ,4416 ,3856 ,3145 ,20680
2017-05-22 ,2776 ,10932 ,5474 ,5063 ,4077 ,28322
2017-05-23 ,2484 ,11106 ,5654 ,5023 ,4171 ,28438
2017-05-24 ,2700 ,10822 ,5349 ,5078 ,3945 ,27894
2017-05-25 ,2575 ,11021 ,5412 ,5154 ,4102 ,28264
2017-05-26 ,2733 ,10934 ,5610 ,5121 ,4226 ,28624
2017-05-27 ,1974 ,7488 ,4457 ,3345 ,3671 ,20935
2017-05-28 ,2232 ,5886 ,3727 ,3168 ,2607 ,17620
2017-05-29 ,2636 ,11359 ,1105 ,4774 ,4183 ,24057
2017-05-30 ,2953 ,11162 ,5292 ,5013 ,4159 ,28579
2017-05-31 ,2822 ,11557 ,5694 ,5351 ,4472 ,29896
2017-06-01 ,2792 ,10909 ,5324 ,5085 ,4511 ,28621
2017-06-02 ,2776 ,11493 ,5623 ,5270 ,4389 ,29551
2017-06-03 ,2133 ,7555 ,4622 ,3840 ,3559 ,21709
2017-06-04 ,1844 ,6009 ,3942 ,3306 ,2531 ,17632
2017-06-05 ,3157 ,10853 ,5517 ,5368 ,4398 ,29293
2017-06-06 ,2442 ,10610 ,4936 ,4968 ,3604 ,26560
2017-06-07 ,2865 ,11193 ,5515 ,5386 ,4318 ,29277
2017-06-08 ,2934 ,11335 ,5457 ,5235 ,4439 ,29400
2017-06-09 ,2469 ,10942 ,5534 ,5301 ,4516 ,28762
2017-06-10 ,1277 ,5350 ,3861 ,3031 ,2835 ,16354
2017-06-11 ,1719 ,5913 ,3560 ,3316 ,2691 ,17199
2017-06-12 ,3278 ,10628 ,2302 ,4611 ,3879 ,24698
2017-06-13 ,3308 ,10707 ,2321 ,5122 ,4233 ,25691
2017-06-14 ,2869 ,11572 ,5406 ,5307 ,4335 ,29489
2017-06-15 ,1616 ,6435 ,3352 ,3094 ,2603 ,17100
2017-06-16 ,2740 ,11415 ,5136 ,5371 ,4205 ,28867
2017-06-17 ,2036 ,7349 ,4323 ,3921 ,3118 ,20747
2017-06-18 ,1862 ,6016 ,3637 ,3265 ,2642 ,17422
2017-06-19 ,2814 ,11129 ,5254 ,5249 ,4381 ,28827
2017-06-20 ,3017 ,11314 ,5515 ,5386 ,4403 ,29635
2017-06-21 ,1652 ,6202 ,3483 ,3117 ,2830 ,17284
2017-06-22 ,2939 ,11193 ,5398 ,5213 ,4208 ,28951
2017-06-23 ,3003 ,11301 ,5520 ,5097 ,4370 ,29291
2017-06-24 ,1807 ,7081 ,4450 ,4018 ,3546 ,20902
2017-06-25 ,1739 ,5989 ,3674 ,3168 ,2576 ,17146
2017-06-26 ,2782 ,10734 ,5343 ,5220 ,4352 ,28431
2017-06-27 ,2547 ,10785 ,5300 ,5089 ,4156 ,27877
2017-06-28 ,2665 ,10629 ,5565 ,5012 ,4255 ,28126
2017-06-29 ,2829 ,11106 ,5238 ,5234 ,4131 ,28538
2017-06-30 ,2484 ,11029 ,5369 ,5209 ,4013 ,28104
2017-07-01 ,1947 ,7490 ,4712 ,4136 ,3422 ,21707
2017-07-02 ,1742 ,5548 ,3451 ,2987 ,2438 ,16166
2017-07-03 ,1821 ,10076 ,4552 ,4657 ,3196 ,24302
2017-07-04 ,2159 ,10143 ,4536 ,4763 ,3396 ,24997
2017-07-05 ,2009 ,10073 ,4653 ,4722 ,3411 ,24868
2017-07-06 ,1959 ,9476 ,4591 ,4522 ,3380 ,23928
2017-07-07 ,2083 ,9780 ,4370 ,4650 ,3194 ,24077
2017-07-08 ,2002 ,7276 ,4166 ,3650 ,3092 ,20186
2017-07-09 ,1890 ,6338 ,3610 ,3376 ,2705 ,17919
2017-07-10 ,2023 ,9589 ,4333 ,4987 ,3020 ,23952
2017-07-11 ,1865 ,8597 ,2265 ,4885 ,2246 ,19858
2017-07-12 ,1900 ,9660 ,4379 ,4714 ,3372 ,24025
2017-07-13 ,2104 ,10468 ,4845 ,5008 ,3457 ,25882
2017-07-14 ,1927 ,9770 ,4560 ,5119 ,3193 ,24569
2017-07-15 ,1254 ,7488 ,4652 ,4190 ,3266 ,20850
2017-07-16 ,2170 ,7421 ,3437 ,3513 ,2730 ,19271
2017-07-17 ,1886 ,6798 ,3315 ,2813 ,2490 ,17302
2017-07-18 ,2053 ,10200 ,4415 ,4837 ,3311 ,24816
2017-07-19 ,1990 ,10713 ,4744 ,5205 ,3284 ,25936
2017-07-20 ,2043 ,11019 ,4531 ,4698 ,3460 ,25751
2017-07-21 ,2007 ,10946 ,4656 ,4850 ,3411 ,25870
2017-07-22 ,1917 ,8343 ,4370 ,3732 ,3136 ,21498
2017-07-23 ,2360 ,7198 ,4078 ,3417 ,2084 ,19137
2017-07-24 ,2930 ,11069 ,5177 ,5157 ,3822 ,28155
2017-07-25 ,2806 ,10591 ,5447 ,5250 ,4081 ,28175
2017-07-26 ,2852 ,11056 ,5422 ,5379 ,4035 ,28744
2017-07-27 ,2765 ,10602 ,5218 ,5360 ,4039 ,27984
2017-07-28 ,2750 ,11095 ,5226 ,5153 ,4011 ,28235
2017-07-29 ,2134 ,5814 ,4083 ,3269 ,3187 ,18487
2017-07-30 ,1913 ,6209 ,3843 ,3438 ,2952 ,18355
2017-07-31 ,3100 ,10491 ,5469 ,5322 ,4143 ,28525
2017-08-01 ,2689 ,11018 ,5227 ,5206 ,4275 ,28415
2017-08-02 ,3090 ,11545 ,5792 ,5369 ,4199 ,29995
2017-08-03 ,2737 ,11735 ,6138 ,5244 ,4330 ,30184
2017-08-04 ,2528 ,11487 ,5060 ,5083 ,3699 ,27857
2017-08-05 ,1849 ,7522 ,4391 ,3702 ,2930 ,20394
2017-08-06 ,2096 ,7003 ,3524 ,3431 ,2560 ,18614
2017-08-07 ,1795 ,7146 ,3635 ,3085 ,2500 ,18161
2017-08-08 ,2521 ,12168 ,5846 ,5835 ,4362 ,30732
2017-08-09 ,2667 ,11961 ,5998 ,5600 ,4288 ,30514
2017-08-10 ,2348 ,12284 ,6058 ,6054 ,4538 ,31282
2017-08-11 ,1994 ,12662 ,5991 ,5804 ,4552 ,31003
2017-08-12 ,1845 ,8139 ,4034 ,3518 ,3010 ,20546
2017-08-13 ,2059 ,6409 ,3602 ,3204 ,2376 ,17650
2017-08-14 ,2005 ,11573 ,5582 ,5367 ,4147 ,28674
2017-08-15 ,2351 ,11604 ,5861 ,5506 ,4264 ,29586
2017-08-16 ,1949 ,11257 ,5764 ,5514 ,4173 ,28657
2017-08-17 ,1887 ,11815 ,6161 ,5633 ,4656 ,30152
2017-08-18 ,1836 ,11092 ,5729 ,5411 ,4322 ,28390
2017-08-19 ,1716 ,7826 ,4581 ,3901 ,3096 ,21120
2017-08-20 ,2049 ,6405 ,3817 ,3158 ,2414 ,17843
2017-08-21 ,2322 ,11480 ,6027 ,5745 ,4179 ,29753
2017-08-22 ,2290 ,10945 ,6021 ,5377 ,4015 ,28648
2017-08-23 ,2156 ,11449 ,5969 ,5617 ,4234 ,29425
2017-08-24 ,2700 ,10887 ,5908 ,5386 ,4177 ,29058
2017-08-25 ,2616 ,10738 ,5665 ,5371 ,4226 ,28616
2017-08-26 ,1849 ,7188 ,4601 ,3887 ,3461 ,20986
2017-08-27 ,1952 ,5586 ,3907 ,3353 ,2540 ,17338
2017-08-28 ,2390 ,11215 ,5906 ,5505 ,4192 ,29208
2017-08-29 ,2437 ,9875 ,5882 ,5616 ,4084 ,27894
2017-08-30 ,2466 ,10780 ,6102 ,5479 ,3807 ,28634
2017-08-31 ,2521 ,10812 ,5897 ,5292 ,4077 ,28599
2017-09-01 ,2502 ,10096 ,5819 ,5283 ,3970 ,27670
2017-09-02 ,2043 ,7336 ,4970 ,4214 ,3283 ,21846
2017-09-04 ,2460 ,10719 ,5853 ,5236 ,4112 ,28380
2017-09-05 ,2701 ,10554 ,5891 ,5268 ,3952 ,28366
2017-09-06 ,2667 ,10645 ,5629 ,5349 ,4058 ,28348
2017-09-07 ,2182 ,10441 ,5536 ,5215 ,3893 ,27267
2017-09-08 ,2023 ,10812 ,5983 ,5362 ,4180 ,28360
2017-09-09 ,1906 ,7445 ,4681 ,3748 ,3438 ,21218
2017-09-10 ,2102 ,5881 ,4232 ,3057 ,2699 ,17971
2017-09-11 ,2551 ,10355 ,5508 ,5216 ,3902 ,27532
2017-09-12 ,2608 ,9915 ,5391 ,5199 ,3857 ,26970
2017-09-13 ,2676 ,10202 ,5780 ,5191 ,3708 ,27557
2017-09-14 ,2609 ,10410 ,5457 ,5007 ,3824 ,27307
2017-09-15 ,2625 ,10385 ,5480 ,5198 ,3905 ,27593
2017-09-16 ,1985 ,6908 ,4412 ,3651 ,2940 ,19896
2017-09-17 ,1940 ,5167 ,3450 ,3083 ,2298 ,15938
2017-09-18 ,2721 ,10854 ,5555 ,5331 ,3990 ,28451
2017-09-19 ,2491 ,10600 ,5723 ,5229 ,3919 ,27962
2017-09-20 ,2807 ,10993 ,5722 ,5272 ,3940 ,28734
2017-09-21 ,2697 ,10794 ,5278 ,5012 ,3826 ,27607
2017-09-22 ,2804 ,11021 ,5493 ,5159 ,3858 ,28335
2017-09-23 ,1915 ,5794 ,3962 ,3205 ,2836 ,17712
2017-09-24 ,2047 ,4594 ,3618 ,3022 ,2403 ,15684
2017-09-25 ,2578 ,10385 ,5272 ,4904 ,3871 ,27010
2017-09-26 ,2362 ,10070 ,5373 ,4988 ,3879 ,26672
2017-09-27 ,2584 ,10218 ,5786 ,5047 ,3692 ,27327
2017-09-28 ,2718 ,10318 ,5480 ,5191 ,3812 ,27519
2017-09-29 ,2490 ,10899 ,5684 ,5071 ,4111 ,28255
2017-09-30 ,2227 ,7155 ,4351 ,3978 ,3852 ,21563
2017-10-01 ,2050 ,5011 ,3803 ,3254 ,2616 ,16734
2017-10-02 ,2387 ,10354 ,5455 ,5092 ,3967 ,27255
2017-10-03 ,2709 ,10414 ,5457 ,5504 ,3848 ,27932
2017-10-04 ,2414 ,10805 ,5293 ,5290 ,3950 ,27752
2017-10-05 ,2517 ,9565 ,5414 ,5020 ,3957 ,26473
2017-10-06 ,2490 ,10356 ,5388 ,5195 ,4062 ,27491
2017-10-07 ,2313 ,6865 ,4590 ,3799 ,3294 ,20861
2017-10-08 ,2032 ,5532 ,3665 ,3199 ,2742 ,17170
2017-10-09 ,2640 ,10343 ,5408 ,5026 ,3969 ,27386
2017-10-10 ,2531 ,11143 ,5956 ,5751 ,4141 ,29522
2017-10-11 ,2409 ,10182 ,5733 ,4999 ,3665 ,26988
2017-10-12 ,2469 ,10592 ,5481 ,4953 ,4016 ,27511
2017-10-13 ,2396 ,10592 ,5582 ,4996 ,3854 ,27420
2017-10-14 ,2000 ,6699 ,4389 ,3574 ,3170 ,19832
2017-10-15 ,1766 ,4664 ,3166 ,2887 ,2278 ,14761
2017-10-16 ,2459 ,10430 ,5639 ,4870 ,3806 ,27204
2017-10-17 ,2286 ,10224 ,5434 ,4969 ,3899 ,26812
2017-10-18 ,1376 ,10416 ,5413 ,5127 ,3783 ,26115
2017-10-19 ,2295 ,10119 ,5713 ,5372 ,3843 ,27342
2017-10-20 ,2583 ,10515 ,5539 ,5193 ,3872 ,27702
2017-10-21 ,2048 ,7162 ,4716 ,4356 ,3312 ,21594
2017-10-22 ,2055 ,5612 ,3915 ,3353 ,2643 ,17578
2017-10-23 ,2355 ,10183 ,5445 ,5286 ,3923 ,27192
2017-10-24 ,2414 ,10557 ,5452 ,5272 ,3839 ,27534
2017-10-25 ,2455 ,10629 ,5376 ,5090 ,3592 ,27142
2017-10-26 ,2544 ,11016 ,5287 ,5206 ,3995 ,28048
2017-10-27 ,2413 ,11075 ,5435 ,5125 ,3641 ,27689
2017-10-28 ,1862 ,7516 ,4772 ,4029 ,3059 ,21238
2017-10-29 ,1566 ,6242 ,4099 ,3348 ,2695 ,17950
2017-10-30 ,2645 ,10675 ,5554 ,5551 ,3845 ,28270
2017-10-31 ,2745 ,12294 ,5583 ,5561 ,3954 ,30137
2017-11-01 ,2362 ,10183 ,5221 ,5166 ,3888 ,26820
2017-11-02 ,1885 ,5948 ,4437 ,3371 ,2443 ,18084
2017-11-03 ,2504 ,10476 ,5229 ,4922 ,3892 ,27023
2017-11-04 ,1675 ,7158 ,4170 ,3451 ,2878 ,19332
2017-11-05 ,1667 ,6295 ,3613 ,2996 ,2400 ,16971
2017-11-06 ,2400 ,10247 ,5533 ,5100 ,3844 ,27124
2017-11-07 ,2587 ,10272 ,5644 ,5116 ,3966 ,27585
2017-11-08 ,2589 ,10379 ,5431 ,5170 ,4088 ,27657
2017-11-09 ,2712 ,10354 ,5780 ,5411 ,4173 ,28430
2017-11-10 ,2744 ,11065 ,5457 ,5111 ,4065 ,28442
2017-11-11 ,1918 ,6791 ,4149 ,3751 ,2948 ,19557
2017-11-12 ,2132 ,5592 ,3654 ,3294 ,2510 ,17182
2017-11-13 ,2599 ,10293 ,5291 ,5071 ,3811 ,27065
2017-11-14 ,2627 ,10392 ,5406 ,5291 ,3967 ,27683
2017-11-15 ,2637 ,10045 ,5450 ,5029 ,3806 ,26967
2017-11-16 ,2401 ,10458 ,5442 ,5312 ,3945 ,27558
2017-11-17 ,2780 ,10652 ,5678 ,5484 ,4156 ,28750
2017-11-18 ,1684 ,7976 ,4168 ,3898 ,3471 ,21197
2017-11-19 ,1724 ,5575 ,3892 ,3277 ,2582 ,17050
2017-11-20 ,2725 ,10527 ,5335 ,5179 ,3744 ,27510
2017-11-21 ,2542 ,10859 ,5438 ,5388 ,3910 ,28137
2017-11-22 ,2821 ,10334 ,5509 ,5451 ,4019 ,28134
2017-11-23 ,2569 ,10262 ,5255 ,5223 ,3790 ,27099
2017-11-24 ,2182 ,10378 ,5531 ,5365 ,3819 ,27275
2017-11-25 ,1693 ,6924 ,4300 ,3740 ,3082 ,19739
2017-11-26 ,1498 ,5604 ,3741 ,3266 ,2562 ,16671
2017-11-27 ,2490 ,9899 ,5452 ,5227 ,3750 ,26818
2017-11-28 ,2150 ,10177 ,5130 ,5197 ,3632 ,26286
2017-11-29 ,2559 ,9905 ,5493 ,5489 ,3774 ,27220
2017-11-30 ,2324 ,10384 ,5179 ,5148 ,3832 ,26867
2017-12-01 ,2295 ,10264 ,5193 ,5204 ,3740 ,26696
2017-12-02 ,1286 ,6377 ,3726 ,3403 ,2730 ,17522
2017-12-04 ,1986 ,9799 ,4966 ,4868 ,3236 ,24855
2017-12-05 ,2048 ,10185 ,4864 ,5144 ,3454 ,25695
2017-12-06 ,2216 ,9804 ,5103 ,5264 ,3523 ,25910
2017-12-07 ,1997 ,9189 ,4842 ,4665 ,3576 ,24269
2017-12-08 ,2200 ,9953 ,4611 ,5063 ,3511 ,25338
2017-12-09 ,1775 ,7500 ,4732 ,4350 ,3816 ,22173
2017-12-10 ,1881 ,6325 ,4166 ,3713 ,3053 ,19138
2017-12-11 ,2166 ,10236 ,4712 ,4881 ,3377 ,25372
2017-12-12 ,1988 ,9570 ,4761 ,5025 ,3341 ,24685
2017-12-13 ,1892 ,9837 ,4672 ,4968 ,3214 ,24583
2017-12-14 ,1796 ,10075 ,4516 ,4752 ,3307 ,24446
2017-12-15 ,2246 ,10368 ,4755 ,5179 ,3490 ,26038
2017-12-16 ,1761 ,7799 ,4273 ,3899 ,2912 ,20644
2017-12-17 ,2030 ,6869 ,4011 ,3594 ,2854 ,19358
2017-12-18 ,2012 ,9846 ,4491 ,4636 ,3239 ,24224
2017-12-19 ,1503 ,9368 ,4475 ,4575 ,3184 ,23105
2017-12-20 ,1899 ,8795 ,3759 ,4723 ,3094 ,22270
2017-12-21 ,1296 ,8761 ,4288 ,4182 ,3162 ,21689
2017-12-22 ,2267 ,8879 ,4431 ,4569 ,3209 ,23355
2017-12-23 ,2678 ,7270 ,4883 ,3948 ,3407 ,22186
2017-12-24 ,1096 ,5506 ,3894 ,3216 ,2788 ,16500
2017-12-25 ,2075 ,5756 ,4151 ,3213 ,2869 ,18064
2017-12-26 ,1682 ,7612 ,3672 ,3873 ,2505 ,19344
2017-12-27 ,1682 ,7727 ,4050 ,4254 ,2677 ,20390
2017-12-28 ,1563 ,7981 ,3799 ,4060 ,2461 ,19864
2017-12-29 ,1439 ,7779 ,3732 ,3969 ,2427 ,19346
2017-12-30 ,1394 ,5194 ,3325 ,3048 ,2304 ,15265
2017-12-31 ,1304 ,4385 ,2856 ,2276 ,1955 ,12776
2018-01-01 ,1955 ,5871 ,3563 ,2743 ,2505 ,16637
2018-01-02 ,1619 ,7749 ,3813 ,3778 ,2774 ,19733
2018-01-03 ,1565 ,7935 ,3913 ,4136 ,2555 ,20104
2018-01-04 ,1946 ,8076 ,3838 ,4023 ,3221 ,21104
2018-01-05 ,1788 ,8177 ,3863 ,3979 ,2733 ,20540
2018-01-06 ,1593 ,5638 ,3622 ,3292 ,2327 ,16472
2018-01-07 ,1684 ,4988 ,3291 ,2936 ,2284 ,15183
2018-01-08 ,1745 ,7947 ,3808 ,4043 ,2359 ,19902
2018-01-09 ,1628 ,8273 ,3969 ,3956 ,2400 ,20226
2018-01-10 ,1595 ,8403 ,4011 ,4082 ,2323 ,20414
2018-01-11 ,2926 ,6597 ,3999 ,5143 ,2496 ,21161
2018-01-12 ,1860 ,8502 ,3922 ,4622 ,2545 ,21451
2018-01-13 ,1526 ,5233 ,3175 ,3259 ,2155 ,15348
2018-01-14 ,1681 ,4795 ,3147 ,2884 ,2052 ,14559
2018-01-15 ,1889 ,8683 ,4194 ,4293 ,2724 ,21783
2018-01-16 ,1753 ,8703 ,4214 ,4608 ,2744 ,22022
2018-01-17 ,1702 ,8983 ,4401 ,4757 ,2825 ,22668
2018-01-18 ,1692 ,9399 ,4446 ,4680 ,2880 ,23097
2018-01-19 ,1579 ,8888 ,4223 ,4326 ,2753 ,21769
2018-01-20 ,1330 ,5577 ,3423 ,3051 ,2083 ,15464
2018-01-21 ,1535 ,5243 ,3267 ,2967 ,2201 ,15213
2018-01-22 ,1567 ,5306 ,3438 ,2791 ,2286 ,15388
2018-01-23 ,1951 ,9098 ,4529 ,4415 ,2905 ,22898
2018-01-24 ,1839 ,9174 ,5068 ,4799 ,2854 ,23734
2018-01-25 ,1539 ,9812 ,4326 ,5010 ,2562 ,23249
2018-01-26 ,1850 ,9916 ,4815 ,4953 ,3382 ,24916
2018-01-27 ,1366 ,7584 ,4390 ,4305 ,3093 ,20738
2018-01-28 ,1455 ,5816 ,3937 ,3411 ,2533 ,17152
2018-01-29 ,1719 ,9667 ,4708 ,4623 ,3066 ,23783
2018-01-30 ,2009 ,9888 ,4509 ,4684 ,3135 ,24225
2018-01-31 ,1763 ,9262 ,4862 ,4883 ,3194 ,23964
2018-02-01 ,1475 ,9295 ,4500 ,4513 ,2805 ,22588
2018-02-02 ,1804 ,10120 ,4693 ,4774 ,3164 ,24555
2018-02-03 ,1594 ,6652 ,4234 ,3596 ,2777 ,18853
2018-02-04 ,1715 ,6091 ,3980 ,3988 ,2601 ,18375
2018-02-05 ,2594 ,10931 ,5426 ,5347 ,3859 ,28157
2018-02-06 ,2391 ,10629 ,5438 ,5180 ,3756 ,27394
2018-02-07 ,436 ,1438 ,1022 ,842 ,1062 ,4800
2018-02-08 ,2510 ,11002 ,5655 ,5203 ,4047 ,28417
2018-02-09 ,2410 ,10127 ,4877 ,4698 ,3632 ,25744
2018-02-10 ,2115 ,6784 ,4398 ,4123 ,2896 ,20316
2018-02-11 ,2013 ,4637 ,3657 ,2861 ,2266 ,15434
2018-02-12 ,1873 ,4372 ,3376 ,2910 ,2755 ,15286
2018-02-13 ,1680 ,5117 ,3379 ,2972 ,2553 ,15701
2018-02-14 ,2636 ,10707 ,5476 ,5187 ,4049 ,28055
2018-02-15 ,2459 ,10982 ,5378 ,5173 ,4011 ,28003
2018-02-16 ,2215 ,10419 ,5205 ,4836 ,3768 ,26443
2018-02-17 ,1506 ,7053 ,4404 ,4201 ,3174 ,20338
2018-02-18 ,1660 ,5905 ,4435 ,3984 ,2655 ,18639
2018-02-19 ,2576 ,10954 ,5678 ,5392 ,4041 ,28641
2018-02-20 ,2368 ,10988 ,5352 ,5105 ,3894 ,27707
2018-02-21 ,924 ,3017 ,1991 ,1700 ,1581 ,9213
2018-02-22 ,2410 ,10780 ,5317 ,5068 ,3809 ,27384
2018-02-23 ,2302 ,10962 ,5345 ,5210 ,3961 ,27780
2018-02-24 ,1541 ,6552 ,4273 ,4212 ,2905 ,19483
2018-02-25 ,1605 ,6131 ,4409 ,3762 ,2883 ,18790
2018-02-26 ,2274 ,11036 ,5444 ,5081 ,3828 ,27663
2018-02-27 ,2321 ,10717 ,5625 ,5082 ,3849 ,27594
2018-02-28 ,2249 ,10758 ,5392 ,5047 ,3749 ,27195
2018-03-01 ,2417 ,10790 ,5777 ,5166 ,3744 ,27894
2018-03-02 ,2374 ,10830 ,5403 ,5033 ,3933 ,27573
2018-03-03 ,1628 ,7267 ,4427 ,4289 ,3153 ,20764
2018-03-04 ,1664 ,6571 ,4644 ,4063 ,2350 ,19292
2018-03-05 ,2419 ,10187 ,5391 ,4899 ,3929 ,26825
2018-03-06 ,2379 ,10503 ,5316 ,4800 ,3783 ,26781
2018-03-07 ,2264 ,10388 ,5342 ,4904 ,3651 ,26549
2018-03-08 ,2467 ,10271 ,5431 ,5012 ,3749 ,26930
2018-03-09 ,2289 ,10481 ,5214 ,4893 ,3484 ,26361
2018-03-10 ,1626 ,5351 ,3984 ,3480 ,2665 ,17106
2018-03-11 ,1565 ,4830 ,3372 ,2985 ,2286 ,15038
2018-03-12 ,2294 ,10323 ,5355 ,5048 ,3779 ,26799
2018-03-13 ,2345 ,10611 ,5161 ,5028 ,3570 ,26715
2018-03-14 ,2234 ,9630 ,5432 ,4654 ,3622 ,25572
2018-03-15 ,2273 ,10158 ,4999 ,4899 ,3856 ,26185
2018-03-16 ,2232 ,9280 ,4695 ,4819 ,3546 ,24572
2018-03-17 ,1991 ,6295 ,3965 ,3474 ,2614 ,18339
2018-03-18 ,1756 ,4740 ,3780 ,2939 ,2182 ,15397
2018-03-19 ,2599 ,9784 ,5029 ,4876 ,3824 ,26112
2018-03-20 ,2317 ,9742 ,4981 ,4843 ,3916 ,25799
2018-03-21 ,2248 ,9658 ,5005 ,4864 ,3712 ,25487
2018-03-22 ,2519 ,10449 ,5371 ,5015 ,4210 ,27564
2018-03-23 ,2541 ,9539 ,5365 ,4636 ,3777 ,25858
2018-03-24 ,1465 ,6326 ,3784 ,3361 ,2902 ,17838
2018-03-25 ,1665 ,4783 ,3303 ,2736 ,2147 ,14634
2018-03-26 ,2283 ,9841 ,5312 ,4858 ,3704 ,25998
2018-03-27 ,2307 ,9845 ,5274 ,4909 ,3638 ,25973
2018-03-28 ,2457 ,10495 ,5418 ,5088 ,3813 ,27271
2018-03-29 ,2152 ,9641 ,4723 ,4482 ,3460 ,24458
2018-03-30 ,1779 ,5195 ,3276 ,2596 ,2030 ,14876
2018-03-31 ,1498 ,5294 ,3322 ,2834 ,2169 ,15117
2018-04-01 ,1452 ,4821 ,2938 ,2703 ,2006 ,13920
2018-04-02 ,2199 ,10187 ,5557 ,4808 ,3926 ,26677
2018-04-03 ,2243 ,10759 ,5619 ,4587 ,4003 ,27211
2018-04-04 ,1893 ,10385 ,5403 ,4827 ,4067 ,26575
2018-04-05 ,2526 ,10194 ,5102 ,4586 ,4200 ,26608
2018-04-06 ,2397 ,9194 ,5258 ,4748 ,4179 ,25776
2018-04-07 ,1615 ,6170 ,4179 ,3557 ,2773 ,18294
2018-04-08 ,1557 ,5320 ,4014 ,3054 ,2446 ,16391
2018-04-09 ,2195 ,10127 ,5428 ,5070 ,4205 ,27025
2018-04-10 ,2010 ,10647 ,5197 ,4966 ,3828 ,26648
2018-04-11 ,2206 ,10282 ,5276 ,4759 ,3849 ,26372
2018-04-12 ,2314 ,10259 ,5663 ,4769 ,3936 ,26941
2018-04-13 ,2170 ,10065 ,5328 ,4734 ,3946 ,26243
2018-04-14 ,1952 ,6544 ,4477 ,3842 ,2911 ,19726
2018-04-15 ,1586 ,5394 ,3780 ,3162 ,2564 ,16486
2018-04-16 ,2185 ,10050 ,5312 ,4738 ,3700 ,25985
2018-04-17 ,2229 ,10280 ,5304 ,4893 ,3746 ,26452
2018-04-18 ,2209 ,9674 ,5366 ,4737 ,3892 ,25878
2018-04-19 ,2158 ,9913 ,5132 ,4786 ,3777 ,25766
2018-04-20 ,2485 ,10276 ,5465 ,4710 ,3919 ,26855
2018-04-21 ,1679 ,6517 ,4283 ,3576 ,2821 ,18876
2018-04-22 ,1513 ,5652 ,3487 ,3046 ,2468 ,16166
2018-04-23 ,2214 ,10191 ,5149 ,4974 ,3646 ,26174
2018-04-24 ,2159 ,10393 ,5167 ,4813 ,4037 ,26569
2018-04-25 ,2093 ,10052 ,5267 ,4718 ,3638 ,25768
2018-04-26 ,2261 ,10005 ,5231 ,4904 ,3600 ,26001
2018-04-27 ,2143 ,10090 ,5359 ,4738 ,3666 ,25996
2018-04-28 ,1291 ,5955 ,3917 ,3439 ,2779 ,17381
2018-04-29 ,1523 ,5284 ,3602 ,2737 ,2375 ,15521
2018-04-30 ,2021 ,9502 ,4777 ,4526 ,3616 ,24442
2018-05-01 ,2136 ,6253 ,3848 ,3060 ,2392 ,17689
2018-05-02 ,2613 ,10778 ,5626 ,4984 ,3896 ,27897
2018-05-03 ,2306 ,9778 ,5222 ,4839 ,4113 ,26258
2018-05-04 ,2255 ,9950 ,5136 ,4767 ,3579 ,25687
2018-05-05 ,1689 ,5767 ,3933 ,3355 ,2834 ,17578
2018-05-06 ,1370 ,4626 ,3185 ,2766 ,1940 ,13887
2018-05-07 ,2411 ,10101 ,5204 ,4593 ,3684 ,25993
2018-05-08 ,2114 ,9674 ,5253 ,4470 ,3691 ,25202
2018-05-09 ,2067 ,9964 ,5404 ,4850 ,3595 ,25880
2018-05-10 ,2184 ,9768 ,5084 ,4581 ,3654 ,25271
2018-05-11 ,2199 ,10172 ,5141 ,4654 ,3771 ,25937
2018-05-12 ,1486 ,6689 ,4313 ,3514 ,3177 ,19179
2018-05-13 ,1551 ,5896 ,3689 ,3070 ,2586 ,16792
2018-05-14 ,2221 ,9556 ,5337 ,4844 ,3584 ,25542
2018-05-15 ,2292 ,9688 ,5368 ,5174 ,3755 ,26277
2018-05-16 ,2316 ,9786 ,5444 ,4903 ,3661 ,26110
2018-05-17 ,2076 ,9691 ,5297 ,4808 ,3447 ,25319
2018-05-18 ,2327 ,9884 ,5170 ,4774 ,3518 ,25673
2018-05-19 ,1966 ,7841 ,4721 ,3778 ,3555 ,21861
2018-05-20 ,1600 ,5149 ,4121 ,3003 ,2341 ,16214
2018-05-21 ,2180 ,9884 ,5340 ,4620 ,3520 ,25544
2018-05-22 ,2163 ,9878 ,5385 ,4849 ,3710 ,25985
2018-05-23 ,2018 ,9708 ,5243 ,4733 ,3615 ,25317
2018-05-24 ,2066 ,9400 ,5281 ,4689 ,3805 ,25241
2018-05-25 ,2185 ,9851 ,5277 ,4735 ,3649 ,25697
2018-05-26 ,1058 ,4492 ,3967 ,2651 ,2446 ,14614
2018-05-27 ,1943 ,5221 ,4733 ,3215 ,2609 ,17721
2018-05-28 ,2312 ,9682 ,5185 ,4679 ,3443 ,25301
2018-05-29 ,2024 ,10057 ,5320 ,4667 ,3386 ,25454
2018-05-30 ,2145 ,9348 ,5415 ,4504 ,3704 ,25116
2018-05-31 ,1308 ,5140 ,3093 ,2701 ,1930 ,14172
2018-06-01 ,1817 ,9502 ,4786 ,4262 ,3046 ,23413
2018-06-02 ,1274 ,5712 ,3990 ,3236 ,2590 ,16802
2018-06-03 ,1284 ,3430 ,2855 ,2057 ,1546 ,11172
2018-06-04 ,2134 ,8973 ,4833 ,4551 ,3239 ,23730
2018-06-05 ,2011 ,9612 ,5049 ,4774 ,3461 ,24907
2018-06-06 ,1880 ,9456 ,4808 ,4520 ,3024 ,23688
2018-06-07 ,2179 ,9471 ,5204 ,4637 ,3610 ,25101
2018-06-08 ,2127 ,9701 ,5058 ,4758 ,3606 ,25250
2018-06-09 ,1387 ,5643 ,3686 ,2961 ,2663 ,16340
2018-06-10 ,1124 ,3872 ,2736 ,2115 ,1675 ,11522
2018-06-11 ,2370 ,9361 ,5249 ,4706 ,3583 ,25269
2018-06-12 ,1834 ,8602 ,5336 ,4880 ,3713 ,24365
2018-06-13 ,2752 ,9201 ,5318 ,4948 ,3513 ,25732
2018-06-14 ,2146 ,9257 ,5294 ,4685 ,3548 ,24930
2018-06-15 ,2277 ,9441 ,5223 ,4555 ,3385 ,24881
2018-06-16 ,1419 ,5702 ,3745 ,3259 ,2419 ,16544
2018-06-17 ,1314 ,4193 ,3664 ,2729 ,1989 ,13889
2018-06-18 ,2276 ,9233 ,5358 ,4739 ,3749 ,25355
2018-06-19 ,2044 ,9070 ,5200 ,4760 ,3509 ,24583
2018-06-20 ,2170 ,8966 ,5331 ,4840 ,3556 ,24863
2018-06-21 ,1188 ,4432 ,3048 ,2378 ,2024 ,13070
2018-06-22 ,2190 ,8963 ,5287 ,4603 ,3498 ,24541
2018-06-23 ,1437 ,5479 ,3889 ,2944 ,2538 ,16287
2018-06-24 ,1455 ,4476 ,3103 ,2352 ,1894 ,13280
2018-06-25 ,1827 ,9478 ,5236 ,4429 ,3274 ,24244
2018-06-26 ,2169 ,9250 ,5042 ,4614 ,3257 ,24332
2018-06-27 ,1905 ,8927 ,5269 ,4554 ,3310 ,23965
2018-06-28 ,2186 ,9000 ,5249 ,4863 ,3522 ,24820
2018-06-29 ,1853 ,9460 ,4914 ,4781 ,3277 ,24285
2018-06-30 ,2106 ,5993 ,4103 ,3359 ,2607 ,18168
2018-07-01 ,1597 ,4637 ,3488 ,2623 ,2157 ,14502
2018-07-02 ,1802 ,7856 ,4412 ,4187 ,2683 ,20940
2018-07-03 ,1569 ,7477 ,4484 ,4115 ,2796 ,20441
2018-07-04 ,1566 ,7597 ,4448 ,4324 ,2958 ,20893
2018-07-05 ,1520 ,7853 ,4434 ,4089 ,2934 ,20830
2018-07-06 ,1658 ,7315 ,4308 ,3857 ,2732 ,19870
2018-07-07 ,1485 ,4690 ,3906 ,3149 ,2398 ,15628
2018-07-08 ,1659 ,4528 ,3583 ,2860 ,2189 ,14819
2018-07-09 ,1641 ,7281 ,4381 ,4256 ,2585 ,20144
2018-07-10 ,1473 ,7240 ,4516 ,4117 ,2702 ,20048
2018-07-11 ,1242 ,7139 ,4695 ,4156 ,2871 ,20103
2018-07-12 ,1419 ,7245 ,4268 ,4035 ,2721 ,19688
2018-07-13 ,1663 ,7871 ,5287 ,4580 ,2981 ,22382
2018-07-14 ,1434 ,5058 ,3794 ,2883 ,2143 ,15312
2018-07-15 ,1739 ,4694 ,3925 ,2777 ,2229 ,15364
2018-07-16 ,1635 ,5129 ,3223 ,2496 ,2135 ,14618
2018-07-17 ,1534 ,8504 ,4194 ,3977 ,2744 ,20953
2018-07-18 ,1451 ,8388 ,4373 ,4053 ,2781 ,21046
2018-07-19 ,1482 ,8302 ,4227 ,3968 ,2724 ,20703
2018-07-20 ,1196 ,8455 ,4354 ,3699 ,2724 ,20428
2018-07-21 ,1502 ,4999 ,3231 ,2642 ,1856 ,14230
2018-07-22 ,1437 ,5764 ,3701 ,2809 ,2045 ,15756
2018-07-23 ,1959 ,8814 ,4901 ,4357 ,3503 ,23534
2018-07-24 ,2111 ,9157 ,4996 ,4562 ,3559 ,24385
2018-07-25 ,2213 ,9004 ,5127 ,4593 ,3477 ,24414
2018-07-26 ,2010 ,9271 ,5061 ,4351 ,3590 ,24283
2018-07-27 ,1963 ,9709 ,5074 ,4391 ,3455 ,24592
2018-07-28 ,1594 ,4791 ,3869 ,3038 ,2400 ,15692
2018-07-29 ,1719 ,5155 ,3670 ,3092 ,2601 ,16237
2018-07-30 ,2424 ,9142 ,5091 ,4572 ,3468 ,24697
2018-07-31 ,2237 ,9236 ,5052 ,4611 ,3378 ,24514
2018-08-01 ,2079 ,9452 ,5346 ,4637 ,3547 ,25061
2018-08-02 ,2043 ,9316 ,5157 ,4955 ,3645 ,25116
2018-08-03 ,2281 ,9730 ,5969 ,4348 ,3886 ,26214
2018-08-04 ,1506 ,5989 ,3506 ,2723 ,2345 ,16069
2018-08-05 ,1697 ,5524 ,3485 ,3094 ,2068 ,15868
2018-08-06 ,1530 ,6074 ,3206 ,2470 ,2031 ,15311
2018-08-07 ,2102 ,9839 ,5223 ,4617 ,3587 ,25368
2018-08-08 ,2180 ,10200 ,5393 ,4638 ,3478 ,25889
2018-08-09 ,2123 ,10207 ,5337 ,4918 ,3585 ,26170
2018-08-10 ,2295 ,11311 ,5398 ,4540 ,3740 ,27284
2018-08-11 ,1551 ,7799 ,4160 ,3377 ,2687 ,19574
2018-08-12 ,1551 ,6113 ,3912 ,3131 ,2360 ,17067
2018-08-13 ,2288 ,9743 ,5384 ,4757 ,3545 ,25717
2018-08-14 ,2107 ,9646 ,5356 ,4792 ,3529 ,25430
2018-08-15 ,2074 ,10245 ,5378 ,4809 ,3710 ,26216
2018-08-16 ,2071 ,10020 ,5237 ,4619 ,3849 ,25796
2018-08-17 ,2210 ,10530 ,5942 ,4865 ,3991 ,27538
2018-08-18 ,1600 ,6502 ,4320 ,3215 ,2567 ,18204
2018-08-19 ,1545 ,5433 ,3720 ,2946 ,2065 ,15709
2018-08-20 ,2124 ,10021 ,5243 ,4582 ,3244 ,25214
2018-08-21 ,1959 ,10036 ,5210 ,4643 ,3431 ,25279
2018-08-22 ,1967 ,10007 ,5487 ,4872 ,3553 ,25886
2018-08-23 ,1923 ,10014 ,5438 ,4890 ,3640 ,25905
2018-08-24 ,1947 ,10135 ,5295 ,4761 ,3538 ,25676
2018-08-25 ,1769 ,6972 ,4016 ,3502 ,2620 ,18879
2018-08-26 ,1584 ,5622 ,3865 ,3052 ,2123 ,16246
2018-08-27 ,2008 ,10328 ,5173 ,4909 ,3366 ,25784
2018-08-28 ,2013 ,10299 ,5360 ,4850 ,3493 ,26015
2018-08-29 ,1942 ,9941 ,5510 ,4891 ,3688 ,25972
2018-08-30 ,2135 ,10032 ,5441 ,4708 ,3474 ,25790
2018-08-31 ,1940 ,10103 ,5426 ,4740 ,3670 ,25879
2018-09-01 ,1452 ,6318 ,4196 ,3714 ,2946 ,18626
2018-09-03 ,2154 ,10392 ,5656 ,4864 ,3700 ,26766
2018-09-04 ,2203 ,10494 ,5622 ,4881 ,3695 ,26895
2018-09-05 ,2084 ,10698 ,5930 ,5190 ,3773 ,27675
2018-09-06 ,2003 ,10082 ,5315 ,5005 ,3669 ,26074
2018-09-07 ,2407 ,9858 ,4861 ,4822 ,3692 ,25640
2018-09-08 ,2148 ,6153 ,4217 ,3878 ,2645 ,19041
2018-09-09 ,1704 ,5641 ,3888 ,3438 ,2387 ,17058
2018-09-10 ,2087 ,10157 ,5252 ,4973 ,4063 ,26532
2018-09-11 ,2006 ,10111 ,5424 ,4867 ,4058 ,26466
2018-09-12 ,2097 ,10131 ,5359 ,5025 ,3764 ,26376
2018-09-13 ,2036 ,10096 ,5190 ,4939 ,3912 ,26173
2018-09-14 ,1882 ,10149 ,5029 ,4527 ,3542 ,25129
2018-09-15 ,1743 ,6618 ,4387 ,3636 ,2889 ,19273
2018-09-16 ,1550 ,4650 ,3591 ,3164 ,2423 ,15378
2018-09-17 ,2213 ,10564 ,5465 ,4939 ,3883 ,27064
2018-09-18 ,2148 ,10453 ,5527 ,4915 ,4080 ,27123
2018-09-19 ,2054 ,10229 ,5496 ,4964 ,3851 ,26594
2018-09-20 ,1962 ,11253 ,5403 ,4855 ,3799 ,27272
2018-09-21 ,2183 ,10638 ,5046 ,4536 ,3660 ,26063
2018-09-22 ,2124 ,6191 ,4451 ,3375 ,2696 ,18837
2018-09-23 ,1417 ,4807 ,3633 ,2949 ,2376 ,15182
2018-09-24 ,1964 ,9983 ,5146 ,4565 ,3550 ,25208
2018-09-25 ,1994 ,10015 ,5237 ,4709 ,3746 ,25701
2018-09-26 ,2020 ,10327 ,5523 ,4985 ,3643 ,26498
2018-09-27 ,2024 ,10080 ,5283 ,4734 ,3876 ,25997
2018-09-28 ,1951 ,9961 ,5170 ,4674 ,3806 ,25562
2018-09-29 ,1372 ,7698 ,4382 ,3798 ,3048 ,20298
2018-09-30 ,1515 ,5297 ,3584 ,3414 ,2475 ,16285
2018-10-01 ,1917 ,10328 ,5111 ,4626 ,3541 ,25523
2018-10-02 ,1987 ,10306 ,5136 ,4768 ,3823 ,26020
2018-10-03 ,2009 ,10533 ,5350 ,4872 ,4003 ,26767
2018-10-04 ,2028 ,10378 ,5342 ,4562 ,3782 ,26092
2018-10-05 ,2066 ,10761 ,5298 ,4652 ,3731 ,26508
2018-10-06 ,1480 ,7165 ,4264 ,3388 ,2889 ,19186
2018-10-07 ,1566 ,5612 ,3682 ,2765 ,2382 ,16007
2018-10-08 ,2117 ,10348 ,5268 ,4834 ,3827 ,26394
2018-10-09 ,2049 ,10276 ,5602 ,4877 ,3851 ,26655
2018-10-10 ,2248 ,4183 ,5052 ,2455 ,3467 ,17405
2018-10-11 ,1883 ,9862 ,5341 ,4616 ,3500 ,25202
2018-10-12 ,1862 ,10305 ,5204 ,4883 ,3617 ,25871
2018-10-13 ,2662 ,5177 ,4139 ,3480 ,3404 ,18862
2018-10-14 ,1308 ,5000 ,3461 ,2809 ,2203 ,14781
2018-10-15 ,2018 ,10039 ,5169 ,4489 ,3547 ,25262
2018-10-16 ,2047 ,10401 ,5575 ,4949 ,3809 ,26781
2018-10-17 ,1938 ,10318 ,5609 ,4941 ,3852 ,26658
2018-10-18 ,2017 ,10477 ,5729 ,4874 ,4034 ,27131
2018-10-19 ,1898 ,9665 ,5512 ,4630 ,3610 ,25315
2018-10-20 ,1499 ,6259 ,4602 ,3891 ,2996 ,19247
2018-10-21 ,1648 ,5489 ,3786 ,3261 ,2712 ,16896
2018-10-22 ,1999 ,9636 ,5447 ,4766 ,3821 ,25669
2018-10-23 ,1893 ,9758 ,5245 ,4772 ,3635 ,25303
2018-10-24 ,1993 ,9715 ,5535 ,4876 ,3771 ,25890
2018-10-25 ,2082 ,9594 ,5207 ,4565 ,3566 ,25014
2018-10-26 ,2020 ,10108 ,5117 ,4679 ,3621 ,25545
2018-10-27 ,1564 ,6782 ,5085 ,3284 ,2952 ,19667
2018-10-28 ,1360 ,6240 ,3639 ,3215 ,2489 ,16943
2018-10-29 ,2018 ,10358 ,5294 ,4745 ,3519 ,25934
2018-10-30 ,1950 ,10052 ,5472 ,4702 ,3744 ,25920
2018-10-31 ,2288 ,12177 ,5931 ,5200 ,4048 ,29644
2018-11-01 ,1777 ,9642 ,5242 ,4344 ,3688 ,24693
2018-11-02 ,1326 ,5730 ,4380 ,2869 ,2388 ,16693
2018-11-03 ,1188 ,7326 ,3683 ,3069 ,2530 ,17796
2018-11-04 ,1249 ,5922 ,3295 ,2551 ,2296 ,15313
2018-11-05 ,2157 ,9698 ,5526 ,4740 ,3551 ,25672
2018-11-06 ,1782 ,9907 ,5375 ,4696 ,3884 ,25644
2018-11-07 ,1881 ,9594 ,5461 ,4886 ,3635 ,25457
2018-11-08 ,1859 ,10083 ,5665 ,4998 ,3695 ,26300
2018-11-09 ,1956 ,10480 ,5500 ,4821 ,3815 ,26572
2018-11-10 ,1542 ,7005 ,4271 ,3498 ,3101 ,19417
2018-11-11 ,1488 ,5852 ,3711 ,3293 ,2454 ,16798
2018-11-12 ,1961 ,10188 ,5346 ,4665 ,3511 ,25671
2018-11-13 ,1817 ,10350 ,5606 ,4752 ,3657 ,26182
2018-11-14 ,1940 ,10059 ,5472 ,4787 ,3742 ,26000
2018-11-15 ,2133 ,10544 ,5320 ,4814 ,3840 ,26651
2018-11-16 ,1909 ,10354 ,5815 ,4952 ,4280 ,27310
2018-11-17 ,1548 ,7447 ,4668 ,3805 ,3486 ,20954
2018-11-18 ,1438 ,5297 ,3950 ,3088 ,2567 ,16340
2018-11-19 ,1927 ,9682 ,5453 ,4916 ,3774 ,25752
2018-11-20 ,2053 ,9968 ,5328 ,4840 ,3746 ,25935
2018-11-21 ,1825 ,9686 ,5334 ,4774 ,3779 ,25398
2018-11-22 ,1845 ,9952 ,5372 ,4913 ,3651 ,25733
2018-11-23 ,1858 ,10418 ,5478 ,4940 ,3852 ,26546
2018-11-24 ,1362 ,6462 ,3966 ,3361 ,2714 ,17865
2018-11-25 ,1480 ,5294 ,4122 ,3214 ,2379 ,16489
2018-11-26 ,2068 ,9391 ,5717 ,4482 ,3552 ,25210
2018-11-27 ,1728 ,9818 ,5389 ,4750 ,3530 ,25215
2018-11-28 ,1878 ,9989 ,5639 ,4780 ,3677 ,25963
2018-11-29 ,1875 ,9696 ,5093 ,4689 ,3566 ,24919
2018-11-30 ,1888 ,10262 ,5258 ,4909 ,3689 ,26006
2018-12-01 ,1324 ,6759 ,4151 ,4014 ,2961 ,19209
2018-12-02 ,1479 ,5254 ,3777 ,3514 ,2430 ,16454
2018-12-03 ,2104 ,9790 ,5218 ,4629 ,3531 ,25272
2018-12-04 ,1530 ,9850 ,5185 ,4712 ,3410 ,24687
2018-12-05 ,1904 ,10051 ,5363 ,4998 ,3627 ,25943
2018-12-06 ,780 ,2469 ,1928 ,1587 ,1378 ,8142
2018-12-07 ,1818 ,9980 ,5056 ,4670 ,3993 ,25517
2018-12-08 ,1372 ,7312 ,4245 ,3618 ,2875 ,19422
2018-12-09 ,1448 ,6451 ,3818 ,3227 ,2672 ,17616
2018-12-10 ,1352 ,9389 ,4141 ,4309 ,3534 ,22725
2018-12-11 ,1376 ,9750 ,4383 ,4405 ,3426 ,23340
2018-12-12 ,1425 ,9645 ,4519 ,5036 ,3305 ,23930
2018-12-13 ,1359 ,9677 ,4283 ,4402 ,3196 ,22917
2018-12-14 ,1763 ,9687 ,4195 ,4329 ,3439 ,23413
2018-12-15 ,1495 ,7414 ,4744 ,4428 ,3872 ,21953
2018-12-16 ,1391 ,6217 ,3401 ,3280 ,2716 ,17005
2018-12-17 ,1352 ,8824 ,4088 ,3703 ,3051 ,21018
2018-12-18 ,1406 ,8694 ,4157 ,4102 ,3130 ,21489
2018-12-19 ,1359 ,8708 ,4553 ,4077 ,2943 ,21640
2018-12-20 ,1345 ,8754 ,4397 ,4285 ,3080 ,21861
2018-12-21 ,1455 ,8908 ,4550 ,4015 ,2982 ,21910
2018-12-22 ,1369 ,6660 ,4583 ,3525 ,2735 ,18872
2018-12-23 ,1639 ,5999 ,4020 ,3408 ,2719 ,17785
2018-12-24 ,1673 ,8240 ,4272 ,3653 ,2862 ,20700
2018-12-25 ,1551 ,5802 ,4464 ,3131 ,2872 ,17820
2018-12-26 ,1111 ,7503 ,3891 ,3785 ,2551 ,18841
2018-12-27 ,1171 ,7302 ,3843 ,3439 ,2304 ,18059
2018-12-28 ,1168 ,7447 ,4039 ,3530 ,2312 ,18496
2018-12-29 ,819 ,4681 ,3393 ,2634 ,1838 ,13365
2018-12-30 ,1017 ,4240 ,2977 ,2579 ,1875 ,12688
2018-12-31 ,825 ,6663 ,3317 ,2908 ,2106 ,15819
2019-01-01 ,1176 ,6040 ,3617 ,2688 ,2506 ,16027
2019-01-02 ,1205 ,7799 ,4009 ,3601 ,2500 ,19114
2019-01-03 ,1012 ,7555 ,3765 ,3433 ,2368 ,18133
2019-01-04 ,957 ,7705 ,3770 ,3549 ,2299 ,18280
2019-01-05 ,943 ,5245 ,3402 ,2822 ,2151 ,14563
2019-01-06 ,1276 ,5154 ,3627 ,3044 ,2255 ,15356
2019-01-07 ,1141 ,8456 ,4172 ,3891 ,2544 ,20204
2019-01-08 ,1132 ,8203 ,4108 ,3851 ,2424 ,19718
2019-01-09 ,1077 ,8355 ,4317 ,3962 ,2653 ,20364
2019-01-10 ,997 ,8515 ,4231 ,3427 ,2561 ,19731
2019-01-11 ,1010 ,8275 ,3986 ,3440 ,2547 ,19258
2019-01-12 ,1769 ,5831 ,3433 ,2921 ,2047 ,16001
2019-01-13 ,1172 ,4694 ,3363 ,2449 ,1899 ,13577
2019-01-14 ,1288 ,8736 ,4402 ,4210 ,2881 ,21517
2019-01-15 ,1184 ,8724 ,4428 ,4062 ,2709 ,21107
2019-01-16 ,1084 ,8966 ,4496 ,4077 ,2797 ,21420
2019-01-17 ,1247 ,9217 ,4411 ,4157 ,2853 ,21885
2019-01-18 ,1298 ,9338 ,4673 ,4230 ,2937 ,22476
2019-01-19 ,1013 ,6134 ,3867 ,3033 ,2260 ,16307
2019-01-20 ,1025 ,5542 ,3739 ,2860 ,2168 ,15334
2019-01-21 ,1212 ,9425 ,4660 ,3902 ,2817 ,22016
2019-01-22 ,966 ,5727 ,3220 ,2674 ,2068 ,14655
2019-01-23 ,1299 ,8824 ,5042 ,4069 ,3443 ,22677
2019-01-24 ,1118 ,8203 ,4819 ,3971 ,3165 ,21276
2019-01-25 ,1158 ,9776 ,4911 ,4381 ,3125 ,23351
2019-01-26 ,990 ,6855 ,4228 ,3581 ,2588 ,18242
2019-01-27 ,1058 ,6003 ,4004 ,3229 ,2618 ,16912
2019-01-28 ,1157 ,8840 ,4686 ,4071 ,2793 ,21547
2019-01-29 ,1057 ,9099 ,4983 ,4376 ,3100 ,22615
2019-01-30 ,1037 ,8447 ,4726 ,4048 ,2769 ,21027
2019-01-31 ,1035 ,8689 ,4514 ,3859 ,3022 ,21119
2019-02-01 ,1149 ,9395 ,4634 ,4160 ,2737 ,22075
2019-02-02 ,1007 ,6689 ,4252 ,3529 ,2517 ,17994
2019-02-03 ,1298 ,5711 ,3896 ,3320 ,2391 ,16616
2019-02-04 ,1809 ,9965 ,5389 ,4748 ,3548 ,25459
2019-02-05 ,1644 ,9539 ,5400 ,4551 ,3351 ,24485
2019-02-06 ,1676 ,9779 ,5422 ,4605 ,3423 ,24905
2019-02-07 ,1625 ,9839 ,5166 ,4680 ,3543 ,24853
2019-02-08 ,1493 ,9996 ,5336 ,4550 ,3643 ,25018
2019-02-09 ,1003 ,6376 ,4308 ,3710 ,2552 ,17949
2019-02-10 ,1000 ,5381 ,3744 ,3131 ,2330 ,15586
2019-02-11 ,1722 ,10321 ,5488 ,4762 ,3668 ,25961
2019-02-12 ,1683 ,10251 ,5176 ,4769 ,3584 ,25463
2019-02-13 ,1648 ,10159 ,5524 ,4892 ,3568 ,25791
2019-02-14 ,1509 ,10033 ,5617 ,4732 ,3662 ,25553
2019-02-15 ,1541 ,10504 ,5736 ,4842 ,3653 ,26276
2019-02-16 ,1001 ,5803 ,4127 ,3199 ,2388 ,16518
2019-02-17 ,1152 ,5934 ,4075 ,3585 ,2311 ,17057
2019-02-18 ,1852 ,10658 ,5553 ,4858 ,3786 ,26707
2019-02-19 ,1563 ,10182 ,5538 ,4727 ,3862 ,25872
2019-02-20 ,1672 ,10200 ,5711 ,4967 ,3700 ,26250
2019-02-21 ,1789 ,10892 ,5833 ,5007 ,3823 ,27344
2019-02-22 ,1771 ,10838 ,5760 ,4899 ,3863 ,27131
2019-02-23 ,1175 ,7613 ,4624 ,3923 ,3199 ,20534
2019-02-24 ,1020 ,5676 ,4572 ,3469 ,2476 ,17213
2019-02-25 ,1654 ,10585 ,5666 ,4702 ,3835 ,26442
2019-02-26 ,1516 ,10139 ,5471 ,4876 ,3802 ,25804
2019-02-27 ,1724 ,10217 ,5571 ,4894 ,3548 ,25954
2019-02-28 ,1734 ,10684 ,5374 ,4710 ,3706 ,26208
2019-03-01 ,1712 ,9473 ,4824 ,4218 ,3304 ,23531
2019-03-02 ,1607 ,6841 ,4688 ,3827 ,3162 ,20125
2019-03-03 ,1231 ,4369 ,3768 ,2670 ,2794 ,14832
2019-03-04 ,1430 ,3716 ,3244 ,2600 ,2993 ,13983
2019-03-05 ,1402 ,4695 ,3344 ,2615 ,2199 ,14255
2019-03-06 ,1882 ,10625 ,5477 ,4546 ,4259 ,26789
2019-03-07 ,1797 ,10609 ,5462 ,4633 ,4021 ,26522
2019-03-08 ,1770 ,10781 ,5515 ,4775 ,4063 ,26904
2019-03-09 ,1210 ,6458 ,4288 ,3759 ,2494 ,18209
2019-03-10 ,1019 ,4511 ,3714 ,3185 ,1972 ,14401
2019-03-11 ,1709 ,9608 ,5453 ,4655 ,3267 ,24692
2019-03-12 ,1592 ,10171 ,5390 ,4596 ,3488 ,25237
2019-03-13 ,1860 ,10372 ,5992 ,4703 ,3689 ,26616
2019-03-14 ,1612 ,10102 ,5626 ,4525 ,3728 ,25593
2019-03-15 ,1581 ,10519 ,5371 ,4678 ,3763 ,25912
2019-03-16 ,1107 ,6270 ,4170 ,3147 ,2540 ,17234
2019-03-17 ,1051 ,5260 ,3574 ,2660 ,2035 ,14580
2019-03-18 ,1858 ,10298 ,5590 ,4577 ,3532 ,25855
2019-03-19 ,1856 ,10048 ,5835 ,4569 ,4149 ,26457
2019-03-20 ,1779 ,10740 ,5807 ,4621 ,3921 ,26868
2019-03-21 ,1697 ,10628 ,5766 ,4701 ,3596 ,26388
2019-03-22 ,2163 ,11316 ,7038 ,5027 ,4223 ,29767
2019-03-23 ,1422 ,7269 ,4796 ,3432 ,2718 ,19637
2019-03-24 ,1339 ,5317 ,3554 ,2795 ,2223 ,15228
2019-03-25 ,2010 ,10444 ,5334 ,4598 ,3570 ,25956
2019-03-26 ,1885 ,10611 ,5334 ,4606 ,3799 ,26235
2019-03-27 ,1967 ,10648 ,8098 ,4739 ,3605 ,29057
2019-03-28 ,2050 ,10939 ,5628 ,4662 ,3720 ,26999
2019-03-29 ,2054 ,11266 ,5662 ,4620 ,3614 ,27216
2019-03-30 ,1398 ,7039 ,4101 ,3585 ,2786 ,18909
2019-03-31 ,1237 ,5253 ,3650 ,2684 ,2232 ,15056
2019-04-01 ,1840 ,10189 ,5426 ,4439 ,3702 ,25596
2019-04-02 ,2002 ,10564 ,5647 ,4583 ,3732 ,26528
2019-04-03 ,1992 ,10431 ,5541 ,4498 ,3661 ,26123
2019-04-04 ,1970 ,10773 ,5711 ,4654 ,3499 ,26607
2019-04-05 ,1991 ,11182 ,6895 ,4744 ,3925 ,28737
2019-04-06 ,1511 ,7130 ,4896 ,3603 ,2631 ,19771
2019-04-07 ,1442 ,5927 ,4071 ,2896 ,2332 ,16668
2019-04-08 ,1929 ,10402 ,5583 ,4819 ,3807 ,26540
2019-04-09 ,2026 ,11379 ,5664 ,4569 ,3902 ,27540
2019-04-10 ,1854 ,10789 ,5904 ,4746 ,3764 ,27057
2019-04-11 ,1969 ,10560 ,5655 ,4541 ,3650 ,26375
2019-04-12 ,2159 ,11330 ,5808 ,4662 ,3872 ,27831
2019-04-13 ,1382 ,7367 ,4429 ,3685 ,3116 ,19979
2019-04-14 ,1643 ,5893 ,4509 ,3125 ,2824 ,17994
2019-04-15 ,1958 ,10945 ,5668 ,4842 ,3800 ,27213
2019-04-16 ,2113 ,10975 ,4965 ,4828 ,3703 ,26584
2019-04-17 ,2058 ,10718 ,5681 ,4929 ,3799 ,27185
2019-04-18 ,1731 ,9942 ,4903 ,4320 ,3462 ,24358
2019-04-19 ,1723 ,5855 ,3061 ,2467 ,2073 ,15179
2019-04-20 ,1699 ,5893 ,3417 ,2852 ,2266 ,16127
2019-04-21 ,1418 ,5247 ,3228 ,2670 ,2172 ,14735
2019-04-22 ,2230 ,11092 ,5734 ,4766 ,3511 ,27333
2019-04-23 ,1957 ,10733 ,5490 ,4676 ,3576 ,26432
2019-04-24 ,2056 ,10395 ,5698 ,4827 ,3641 ,26617
2019-04-25 ,1995 ,10107 ,5510 ,4930 ,3723 ,26265
2019-04-26 ,1982 ,10975 ,5810 ,4856 ,3595 ,27218
2019-04-27 ,1386 ,7008 ,4564 ,3622 ,2821 ,19401
2019-04-28 ,1492 ,5425 ,3492 ,2935 ,2205 ,15549
2019-04-29 ,1826 ,10726 ,4520 ,4700 ,3643 ,25415
2019-04-30 ,1769 ,10502 ,4854 ,4417 ,3495 ,25037
2019-05-01 ,1715 ,6302 ,4268 ,2741 ,2131 ,17157
2019-05-02 ,2441 ,11753 ,5780 ,4797 ,3564 ,28335
2019-05-03 ,2193 ,10903 ,5074 ,4705 ,3469 ,26344
2019-05-04 ,1418 ,6979 ,3709 ,3298 ,3051 ,18455
2019-05-05 ,1320 ,5395 ,3125 ,2584 ,2113 ,14537
2019-05-06 ,2038 ,10947 ,4655 ,4704 ,3490 ,25834
2019-05-07 ,1964 ,10356 ,4476 ,4678 ,3537 ,25011
2019-05-08 ,2236 ,10788 ,4556 ,4634 ,3577 ,25791
2019-05-09 ,1962 ,10830 ,4575 ,4843 ,3591 ,25801
2019-05-10 ,1822 ,11186 ,5028 ,4930 ,3940 ,26906
2019-05-11 ,1402 ,7537 ,3579 ,3447 ,2630 ,18595
2019-05-12 ,1318 ,4759 ,3077 ,2465 ,1972 ,13591
2019-05-13 ,1839 ,10648 ,4353 ,4681 ,3572 ,25093
2019-05-14 ,1930 ,10639 ,4585 ,4856 ,3659 ,25669
2019-05-15 ,1878 ,10860 ,4871 ,4931 ,3498 ,26038
2019-05-16 ,1841 ,10809 ,4645 ,4871 ,3816 ,25982
2019-05-17 ,1860 ,10488 ,4695 ,4913 ,3548 ,25504
2019-05-18 ,1564 ,8229 ,4479 ,4453 ,3417 ,22142
2019-05-19 ,1580 ,6045 ,3716 ,3078 ,2588 ,17007
2019-05-20 ,1838 ,10715 ,4739 ,4668 ,3354 ,25314
2019-05-21 ,1903 ,10900 ,4876 ,4796 ,3678 ,26153
2019-05-22 ,1794 ,10933 ,4913 ,4813 ,3454 ,25907
2019-05-23 ,2042 ,10515 ,4883 ,4558 ,3465 ,25463
2019-05-24 ,1875 ,10470 ,4818 ,4912 ,3484 ,25559
2019-05-25 ,1841 ,8881 ,4022 ,3767 ,3219 ,21730
2019-05-26 ,1508 ,6398 ,3713 ,3002 ,2685 ,17306
2019-05-27 ,2170 ,9500 ,5017 ,4411 ,3755 ,24853
2019-05-28 ,1883 ,10645 ,4698 ,4689 ,3714 ,25629
2019-05-29 ,1782 ,10261 ,4855 ,4732 ,3578 ,25208
2019-05-30 ,1827 ,10641 ,4862 ,4744 ,3594 ,25668
2019-05-31 ,1820 ,10784 ,5027 ,4762 ,3601 ,25994
2019-06-01 ,1687 ,6975 ,3915 ,3619 ,2769 ,18965
2019-06-02 ,1505 ,5221 ,3314 ,2836 ,2068 ,14944
2019-06-03 ,1958 ,10852 ,4909 ,4871 ,3927 ,26517
2019-06-04 ,1955 ,10589 ,4919 ,4832 ,3791 ,26086
2019-06-05 ,2122 ,10592 ,4922 ,5077 ,3557 ,26270
2019-06-06 ,1359 ,10155 ,4232 ,4466 ,3000 ,23212
2019-06-07 ,1827 ,10297 ,4789 ,4600 ,3325 ,24838
2019-06-08 ,1559 ,6994 ,4075 ,3704 ,3133 ,19465
2019-06-09 ,1417 ,5546 ,3688 ,2750 ,2256 ,15657
2019-06-10 ,2067 ,9556 ,4759 ,4844 ,3594 ,24820
2019-06-11 ,2132 ,10596 ,5015 ,4989 ,3598 ,26330
2019-06-12 ,1940 ,10610 ,4998 ,4897 ,3741 ,26186
2019-06-13 ,1995 ,10454 ,4755 ,4893 ,3801 ,25898
2019-06-14 ,2168 ,10431 ,5233 ,4610 ,3860 ,26302
2019-06-15 ,1287 ,4659 ,3565 ,2894 ,2329 ,14734
2019-06-16 ,1246 ,4187 ,3100 ,2463 ,1895 ,12891
2019-06-17 ,2028 ,10229 ,4988 ,4729 ,3601 ,25575
2019-06-18 ,2130 ,10086 ,5331 ,4769 ,3559 ,25875
2019-06-19 ,2025 ,10210 ,5027 ,4587 ,3653 ,25502
2019-06-20 ,1178 ,5342 ,2910 ,2698 ,1888 ,14016
2019-06-21 ,1162 ,5499 ,2715 ,2666 ,1845 ,13887
2019-06-22 ,1267 ,5731 ,3231 ,2773 ,2068 ,15070
2019-06-23 ,1331 ,5080 ,3096 ,2453 ,1927 ,13887
2019-06-24 ,1937 ,10022 ,4618 ,4468 ,3471 ,24516
2019-06-25 ,1821 ,10310 ,4728 ,4630 ,3405 ,24894
2019-06-26 ,2129 ,9217 ,4659 ,4700 ,3253 ,23958
2019-06-27 ,2106 ,10576 ,4480 ,4913 ,3342 ,25417
2019-06-28 ,1783 ,10256 ,4800 ,5001 ,3186 ,25026
2019-06-29 ,1457 ,6848 ,3926 ,3793 ,2981 ,19005
2019-06-30 ,1390 ,5418 ,3364 ,3003 ,2154 ,15329
2019-07-01 ,1485 ,9689 ,4058 ,3990 ,2896 ,22118
2019-07-02 ,1404 ,9711 ,4216 ,4248 ,2794 ,22373
2019-07-03 ,1451 ,9619 ,4305 ,4253 ,2930 ,22558
2019-07-04 ,1551 ,9794 ,4345 ,4234 ,2978 ,22902
2019-07-05 ,1310 ,9673 ,4377 ,4389 ,2839 ,22588
2019-07-06 ,1217 ,6768 ,3764 ,3672 ,2481 ,17902
2019-07-07 ,1399 ,5460 ,3454 ,2915 ,2184 ,15412
2019-07-08 ,1459 ,9229 ,4170 ,3980 ,2879 ,21717
2019-07-09 ,1362 ,9424 ,4218 ,4216 ,2660 ,21880
2019-07-10 ,1371 ,9609 ,4210 ,4428 ,2911 ,22529
2019-07-11 ,1471 ,9546 ,4271 ,4225 ,2698 ,22211
2019-07-12 ,1347 ,9683 ,4307 ,4135 ,2716 ,22188
2019-07-13 ,1239 ,7248 ,3920 ,3279 ,2397 ,18083
2019-07-14 ,1355 ,6059 ,3568 ,2941 ,2336 ,16259
2019-07-15 ,721 ,4409 ,2461 ,2081 ,1966 ,11638
2019-07-16 ,1209 ,5817 ,3189 ,2755 ,2121 ,15091
2019-07-17 ,1530 ,9710 ,4421 ,4292 ,2968 ,22921
2019-07-18 ,1403 ,8836 ,4172 ,3989 ,2673 ,21073
2019-07-19 ,1281 ,8628 ,4231 ,4160 ,2418 ,20718
2019-07-20 ,1151 ,5969 ,3543 ,3220 ,2398 ,16281
2019-07-21 ,1378 ,5009 ,3101 ,2849 ,2168 ,14505
2019-07-22 ,2150 ,9355 ,4800 ,4234 ,3489 ,24028
2019-07-23 ,1751 ,9266 ,4664 ,4172 ,3208 ,23061
2019-07-24 ,1910 ,10139 ,4884 ,4583 ,3651 ,25167
2019-07-25 ,1929 ,10207 ,4743 ,4462 ,3292 ,24633
2019-07-26 ,1840 ,10545 ,4977 ,4665 ,3463 ,25490
2019-07-27 ,1372 ,6721 ,4006 ,3582 ,2701 ,18382
2019-07-28 ,1464 ,5560 ,3373 ,2949 ,2238 ,15584
2019-07-29 ,1969 ,10100 ,5008 ,4712 ,3431 ,25220
2019-07-30 ,1879 ,10363 ,5163 ,4711 ,3541 ,25657
2019-07-31 ,1970 ,10577 ,5064 ,4718 ,3440 ,25769
2019-08-01 ,1953 ,10708 ,4989 ,4704 ,3754 ,26108
2019-08-02 ,2109 ,10378 ,5499 ,4197 ,3529 ,25712
2019-08-03 ,2014 ,5478 ,3859 ,2857 ,2846 ,17054
2019-08-04 ,1680 ,5483 ,3311 ,3288 ,2167 ,15929
2019-08-05 ,1743 ,10670 ,4745 ,4351 ,3246 ,24755
2019-08-06 ,1300 ,6829 ,3323 ,2330 ,2267 ,16049
2019-08-07 ,1969 ,11187 ,5130 ,4845 ,3639 ,26770
2019-08-08 ,1779 ,11331 ,5276 ,4690 ,3642 ,26718
2019-08-09 ,1902 ,11692 ,5839 ,4691 ,3688 ,27812
2019-08-10 ,1359 ,7513 ,4271 ,3438 ,2565 ,19146
2019-08-11 ,1600 ,6439 ,3571 ,2890 ,2155 ,16655
2019-08-12 ,2262 ,11067 ,5702 ,4901 ,4144 ,28076
2019-08-13 ,1851 ,10933 ,5188 ,4586 ,3694 ,26252
2019-08-14 ,2156 ,10927 ,5375 ,4668 ,3692 ,26818
2019-08-15 ,1986 ,10787 ,5367 ,4765 ,3716 ,26621
2019-08-16 ,1952 ,10924 ,5606 ,4877 ,4085 ,27444
2019-08-17 ,1673 ,4739 ,4510 ,3532 ,2574 ,17028
2019-08-18 ,1606 ,5714 ,3664 ,2844 ,2083 ,15911
2019-08-19 ,2046 ,10322 ,5364 ,4775 ,3351 ,25858
2019-08-20 ,2041 ,10784 ,5244 ,4773 ,3898 ,26740
2019-08-21 ,1970 ,3997 ,2706 ,1854 ,1838 ,12365
2019-08-22 ,1976 ,6314 ,5327 ,3027 ,3830 ,20474
2019-08-23 ,1818 ,10818 ,5513 ,4722 ,3668 ,26539
2019-08-24 ,1373 ,6560 ,3934 ,3485 ,2352 ,17704
2019-08-25 ,1714 ,11092 ,3341 ,3806 ,2356 ,22309
2019-08-26 ,2125 ,12360 ,5337 ,5221 ,3706 ,28749
2019-08-27 ,1549 ,12780 ,2655 ,3093 ,2713 ,22790
2019-08-28 ,2095 ,12664 ,5365 ,5318 ,3912 ,29354
2019-08-29 ,1887 ,12230 ,5320 ,5278 ,3765 ,28480
2019-08-30 ,1943 ,11940 ,5262 ,5327 ,3892 ,28364
2019-08-31 ,1849 ,7823 ,4844 ,4091 ,2882 ,21489
2019-09-02 ,2132 ,11569 ,5481 ,5147 ,3768 ,28097
2019-09-03 ,1916 ,11496 ,5071 ,4948 ,3781 ,27212
2019-09-04 ,1964 ,11053 ,5345 ,4950 ,3665 ,26977
2019-09-05 ,1808 ,10423 ,5169 ,4938 ,3738 ,26076
2019-09-06 ,1766 ,10579 ,5037 ,4631 ,3496 ,25509
2019-09-07 ,1539 ,6571 ,3661 ,3543 ,2588 ,17902
2019-09-08 ,1324 ,6298 ,3224 ,2918 ,1812 ,15576
2019-09-09 ,1857 ,10643 ,5328 ,4925 ,3587 ,26340
2019-09-10 ,1847 ,10864 ,5202 ,4660 ,3511 ,26084
2019-09-11 ,1744 ,10986 ,5226 ,5051 ,3507 ,26514
2019-09-12 ,1802 ,10185 ,5205 ,4587 ,3565 ,25344
2019-09-13 ,1866 ,10913 ,5201 ,4546 ,3645 ,26171
2019-09-14 ,1714 ,7257 ,3942 ,3614 ,2627 ,19154
2019-09-15 ,1524 ,5739 ,3106 ,3105 ,2188 ,15662
2019-09-16 ,1823 ,11502 ,5639 ,4831 ,3610 ,27405
2019-09-17 ,1873 ,11208 ,5574 ,4877 ,3747 ,27279
2019-09-18 ,1866 ,11458 ,5266 ,4950 ,3568 ,27108
2019-09-19 ,1803 ,11757 ,5238 ,4971 ,3804 ,27573
2019-09-20 ,2214 ,11244 ,5305 ,4952 ,3800 ,27515
2019-09-21 ,1919 ,7143 ,4338 ,3803 ,3141 ,20344
2019-09-22 ,1558 ,6489 ,3601 ,3405 ,2496 ,17549
2019-09-23 ,1967 ,11109 ,5134 ,4950 ,3537 ,26697
2019-09-24 ,1861 ,11245 ,5239 ,5181 ,3795 ,27321
2019-09-25 ,1979 ,11124 ,5398 ,4746 ,3731 ,26978
2019-09-26 ,1909 ,10893 ,5409 ,4886 ,3943 ,27040
2019-09-27 ,1803 ,11318 ,5344 ,4707 ,5255 ,28427
2019-09-28 ,1953 ,8657 ,4171 ,4187 ,5554 ,24522
2019-09-29 ,1434 ,5828 ,3571 ,3143 ,4142 ,18118
2019-09-30 ,1864 ,11153 ,5341 ,5040 ,4265 ,27663
2019-10-01 ,1847 ,11367 ,5266 ,4694 ,3575 ,26749
2019-10-02 ,2008 ,11136 ,5342 ,4818 ,3665 ,26969
2019-10-03 ,2108 ,11623 ,5203 ,4867 ,3652 ,27453
2019-10-04 ,1982 ,10891 ,5195 ,4774 ,3793 ,26635
2019-10-05 ,1780 ,7437 ,4132 ,3600 ,2695 ,19644
2019-10-06 ,1678 ,5972 ,3600 ,3120 ,2330 ,16700
2019-10-07 ,2229 ,11212 ,5397 ,5050 ,3804 ,27692
2019-10-08 ,1975 ,11448 ,5494 ,5117 ,3782 ,27816
2019-10-09 ,2055 ,11206 ,5647 ,4992 ,3696 ,27596
2019-10-10 ,2325 ,11833 ,5662 ,5020 ,4125 ,28965
2019-10-11 ,2043 ,11558 ,5543 ,4972 ,4021 ,28137
2019-10-12 ,1569 ,7489 ,4455 ,3817 ,2867 ,20197
2019-10-13 ,1516 ,5973 ,3716 ,2918 ,2339 ,16462
2019-10-14 ,2016 ,11114 ,5248 ,4790 ,3633 ,26801
2019-10-15 ,1936 ,11475 ,5621 ,5121 ,3686 ,27839
2019-10-16 ,2164 ,11513 ,5505 ,5057 ,3790 ,28029
2019-10-17 ,2067 ,10765 ,5190 ,4752 ,3613 ,26387
2019-10-18 ,2222 ,11039 ,5356 ,4903 ,3940 ,27460
2019-10-19 ,1381 ,6439 ,4077 ,3443 ,2559 ,17899
2019-10-21 ,1923 ,10796 ,5143 ,4898 ,3736 ,26496
2019-10-22 ,2058 ,9905 ,4933 ,4577 ,3761 ,25234
2019-10-23 ,2006 ,9676 ,4720 ,3543 ,2955 ,22900
2019-10-24 ,2034 ,10349 ,5041 ,4554 ,3504 ,25482
